111111111111111111111
1E000000C000000P00001
101000010001100010101
1010C001000000C010101
101001011001100010101
1010C0011000000010101
101001011001100010101
1010C0011000000010101
100000000C00C000000C1
111111111111111111111
